#########################
#R  #P##     M      P##X#
# # # #### #   ######## #
# # # M  # ####     #   #
#  M  # ##      ##M # # #
# # ### ## ###### MM# # #
# ##P    # #######M # # #
#  #####   ###P ## ## # #
# M M P# #### MM##    M #
##    ##        ## ## #P#
#########################